v/	w
w^	w
afier	after
-we	we
tliat	that
wiih	with
weie	were
th>e	the
v/ikL	will
v;as	was
inh?c!)itants	inhabitants
Tv/o	Two
wa:?	was
olher	other
ofte»	often
ii^habitants	inhabitants
tlie	the
©f	of
vour	your
ofmy	of my
Vv'ith	with
ond	and